1111111111111111111111111111111111111111
1000000000000000C00000000011011000000001
1101011010011111100111110010100110010101
1001011001111000000000011001110011010011
10000011011000010110001110000000C0110101
100C010111010000011110110000001001110001
1000000000P000C0000000010101001101010001
1011101101001100001111110011101101011111
100000001000010000000000C100011001111111
1000100100100001000000011100111001100101
101000000000010110011000010111010000E011
1101111010001100111001001100101000111111
1000111001001001110010101011010000000C01
1111111111111111111111111111111111111111