11111111111111111111111111111111111111111111111111111111
10000000000000000000000000000000000000000000000000000001
10000000000000000000000000000000000000000000000000000001
10000001100000001111111110000000000000000001110000000001
10000000000000000C0000P011110000000000000000000000000001
10001111000000011111111111110000000000000000000000000001
10000000000000000000000000000000000000000000000000000001
100001111100000000000000000C0100000000000000000000000001
10000000000000000111111111100000000000011111000000000001
10000000000000000000000000000000000000000000000000000001
10000111111000000000000000011111000000000000000000000001
10000000000000000000001111110000000000000000000000000001
10000000000000000000111111110110000000001111111000000001
1000000000000000000000E0000C001010C000000000000000000001
11111111111111111111111111111111111111111111111111111111