11111111111111111111111111111111111111111111111111111111
10000000000X00000000000000000000000000000000000000000001
10000000000000000000000000000000000000000000000000000001
100000011000000011111111100000000000X0000001110000000001
10000000000000000C0000P011110000000000000000000000000001
10001111000000011111111111110000000000000000000000X00001
10000000000000000000000000000000000000000000000000000001
100001111100000X00000000000C0X1000000000000000000X00X001
10000000000000000111111111100000000000011111000000000001
1000000000000000X000000000000000X00000000000000000000001
10000111111X00000000000000011111000000000000000000000001
10000000000000000000001111110000000000000000000000000001
10000000000000000000111111110110X00000001111111000000001
10000000000X0000000000E0X00C001010C000000000000000000001
11111111111111111111111111111111111111111111111111111111