1111111111111111111111111111111111111111
100000X000000000C00000000011011000000001
1101011010011111100111110010100110010101
10010110X1111000000000011001110011010011
10000011011000010110001110000000C0110101
100C01011101000001111111000X001001110001
1000000000000X00E0000P001010100110010001
101110110100110X001111110011101101011111
100000001000010000000000C100011001111111
10001001001000010X0000011100111001100101
1010000000000101100110000101110101110011
1101111010001100111001001100101000000001
1000111001X01001110010101011010001100001
1111111111111111111111111111111111111111